atom - A hackable text editor for the 21st Century built on web technologies
alacritty - Alacritty fastest terminal emulator in existence and it is GPU accelerated
eclipse - Eclipse is an integrated development environment used in computer programming
miniconda - The lightweight CLI version of Anaconda
notepad++(WINE) - notepad++ using WINE
postman - Simplify each step of building an API and streamline collaboration so you can create better APIsâ€”faster.
sublime-text - Sublime Text is a sophisticated text editor for code, markup and prose
visual-studio-code - Visual Studio Code is a code editor redefined and optimized for building and debugging modern web and cloud applications
brave - The Brave browser is a fast, private and secure web browser for PC, Mac and mobile
google-chrome-stable - Google Chrome is a fast, easy to use, and secure browser
bashtop - Bashtop is a terminal-based resource monitoring utility in Linux. It's a nifty command-line tool that intuitively displays statistics for your CPU
SDL2 - The SDL library for c++
spotify - Spotify is a digital music service that gives you access to millions of songs.
discord - Discord is the easiest way to talk over voice, video, and text. Talk, chat, hang out, and stay close with your friends and communities
skype - Stay in touch! Free online calls, messaging, affordable international calling to mobiles or landlines and instant online meetings on Skype
microsoft-teams - Video conferencing. Make meetings more personal and increase your productivity by collaborating in real time
hyper - A terminal built on web technologies
matcha-themes - Matcha Gtk Theme is a modern and flat design theme
papirus-icons-gtk - Papirus is a free and open source SVG icon theme for Linux
papirus-icons-kde - Papirus is a free and open source SVG icon theme for Linux
processing3 - Processing is a flexible software sketchbook and a language for learning how to code within the context of the visual arts
elementary-tweaks - Enabling more customization for you elementary install
espanso - An Open Source, Cross-platform Text Expander written in Rust.
ukuu - Ubuntu Kernel Update Utility
parsec - Parsec connects millions of people to their work, games, and friends from anywhere, across any device in silky smooth, ultra high definition interactive video.
ulauncher - An application launcher for linux
etcher - Etcher is a powerful OS image flasher built with web technologies
********************************
There are currently 27 packages
********************************
